#

lvl1tiles.png

11111111111111
10000017055001
10110010111001
15000015051001
10030011100001
10000000305001
10000001011101
10000100000001
10500100010151
10010001110111
11110011000011
15000010355011
10006010000311
11111111111111


t
40



$

lvl2tiles.png


11111111111111
10350005000001
15000001300001
10000011000001
10000017000301
10500011100001
13053000103051
11111110111111
10000500000001
10000001000001
10000501000351
16005001000001
11111331003501
11111111111111


t
40


%

lvl3tiles.png

11111111111111
10000000305151
10301110011101
10001110005101
10001110010101
17005110300061
11111110111111
10030110100001
10515010101101
10111010101031
10000010101051
10000110101051
15110000301051
11111111111111


t
50


